12 8
700 400
3 4 4 4 4 4 4 4 4 4 4 3
3 4 4 4 4 4 4 4 4 4 4 3
3 3 3 3 5 5 5 5 5 3 3 3
3 3 3 3 5 5 5 5 3 3 3 3
3 3 3 3 5 5 5 5 3 3 3 3
3 3 3 3 5 5 5 5 3 3 3 3
3 3 3 3 5 5 5 5 3 3 3 3
3 3 3 3 3 3 3 3 3 3 3 3


